layout[
"% % % % % % % % % % % % % % % % % % % % % % % % % % % %",
"% . . . . . . . . . . . . % % . . . . . . . . . . . . %",
"% . % % % % . % % % % % . % % . % % % % % . % % % % . %",
"% . % % % % . % % % % % . % % . % % % % % . % % % % . %",
"% . % % % % . % % % % % . % % . % % % % % . % % % % . %",
"% + . . . . . . . . . . . . . . . . . . . . . . . . . %",
"% . % % % % . % % . % % % % % % % % . % % . % % % % . %",
"% . % % % % . % % . % % % % % % % % . % % . % % % % . %",
"% . . . . . . % % . . . . % % . . . . % % . . . . . . %",
"% % % % % % . % % % % % . % % . % % % % % . % % % % % %",
"% % % % % % . % % % % % . % % . % % % % % . % % % % % %",
"% % % % % % . % % . . . . . . . . . . % % . % % % % % %",
"% % % % % % . % % . % % % % % % % % . % % . % % % % % %",
"% % % % % % . % % . % % % % % % % % . % % . % % % % % %",
". . . . . . . . . . % % % % % % % % . . . . . . . . . .",
"% % % % % % . % % . % % % % % % % % . % % . % % % % % %",
"% % % % % % . % % . % % % % % % % % . % % . % % % % % %",
"% % % % % % . % % . . . . . . . . . . % % . % % % % % %",
"% % % % % % . % % . % % % % % % % % . % % . % % % % % %",
"% % % % % % % % % % % % % % % % % % % % % % % % % % % %",
]

